R 640 480
NO ./tests/maps/textures/wool_colored_light_blue.xpm
SO ./tests/maps/textures/wool_colored_lime.xpm
WE ./tests/maps/textures/wool_colored_red.xpm
EA ./tests/maps/textures/wool_colored_yellow.xpm
S ./tests/maps/textures/pillar.xpm
F 220,100,0
C 225,30,0
11111111111111111111111111111
10000000001100000000000000001
10110000011100000020000010001
100100000 000000000 0000001 0001
10110 0000 1110 0000020 000010001
100 0000 0001  1 0 0 0001110 11110001
111101111 1111101  1100000010001
11110 111111 1110111   01010010001
1100000 011010101110000 0010001
100 00000 00 000  0 00110 00  00010001
10000 00000000 000  1101 010010001
11000 00011010101  11 110 1 1110 N01
111101 1111 1 1 0101 1111 01 1 110001
11111111111111111 11111 1 1 11111
11111111 1111111111111111 1  1111